Random Note
,1,0,0,0,0,0,0,0,0,0]
Red
,0,0,1,0,0,0,0,0,0,0]
Yellow
,0,0,0,1,0,0,0,0,0,0]
Green
,0,1,0,0,0,0,0,0,0,0]
Blue
,0,0,0,0,1,0,0,0,0,0]

Yellow and Red
,0,0,1,1,0,0,0,0,0,0]
Red and Green
,0,1,0,1,0,0,0,0,0,0]
Green and Blue
,0,1,0,0,1,0,0,0,0,0]
Blue and Yellow
,0,0,1,0,1,0,0,0,0,0]
